R 800 600

F 225, 30, 12
C 225, 30, 12

S  srcs/t/o1.xpm
NO srcs/t/jno.xpm


SO srcs/t/jso.xpm
WE srcs/t/jwe.xpm
EA srcs/t/jea.xpm

111111111111111111111111111111111111111111111111111111111111111111111111111111111111111111111111111111111111111111111111111
1060606060606060606060606060606060606060606060606060606111111111111110P0111111111111111111111111111111111111111111111111111
170000000O000000060000000000000000070000000000000000006B0000000000111000111111111111111111111111111111111111111111111111111
10000N000000000000000000600000000000000007000000000000611111111101111101111111111111111111111111111111111111111111111444111
170000000000000000700000000000000070000006000006000000011170000000066601111111111111111111111111111111111111111111110030411
10000600000000000000000600000060000006000000000000000061110O000000006661111111111111111111111111111111111111111111110004411
170000000000600000000000700000000006000000700000000000011170000006000061111111111111111111111111111111111111000000010001111
100000000000000007000000000000007000000060000000007000611100000000000061111111111111111111111111111111111111001001010001111
170000000060000000000000000700000000000000000000000000011170000000000001111111111111111111111111111111111111001001010001111
100000007000000000000000700000006000000007000000000000611100007000000061111111111111111111111111111111111111001001000001111
170000000000600000000000000000070000000000600000000000011170O00000700001111111111111111111111111111111111111001001111111111
100000000007000000000600000000000000000700000006000000611100000000000061111111111111111111111111111111111111111000000001111
170000000000000000000000000000000000000000000000000000011170000600000001111000010000000000000000000000001110000000000001111
100000000000000700000000000000000000060000000000007000611100000000000061111001010M00000000000000000000001110000000000001111
170000600000000006000000000070000000000000000000000000011100000000000001111001010000000000000000000000001110000000000001111
100007000000000000000000000006000000000070000000600000611170000000000061111001010000000000000000000000001110001111111111111
170000000060000000000000600000000000000000000000000000011100000600000001111001010000000000000000000000001110000000000001111
10000000000000070000000000700000000000700000000O000000611170000000000061111001010000000000000000000000001110000000000004111
1700000006000000000000000000000000000000000000000000000111000000000O000111100100000000000000000000000000F00000000000000IQ11
100000000000000007000000000600000000070000000000000000611170000700000061111001011111111111111111111111111111111110000004111
100070000000700000000000700000000000000000060000000000011100000000000001111001011111111111111111111111111110000010011111111
100000000000000000060000000000000006000000000000000000611170000000600061111001011111111111111111111111111110010010010001111
100000000000000000000000000007000000000000000000700000011100000000000001111001000000000000000000000000001110010010010001111
100000700000000000000006000000000000000070000000000000611170000700000061111001111111111111111111111111111110010010010001111
100000000000000700000000000000000060000000000000000000011100000000000001111001000001000010001000100010001110010010010001111
170006000000000000007000000000000000000000000000000000611170002000200061111001000100001000100010001000101110010010010001111
1000000000000060000000000000000070000000060000000700000111111111A1111111111001111111111111111111111111101110010000000001111
170O00007000000000000000000000600000000000000000000000611111111111111111111000000000000000000000000000001110011111111111111
100000000000000700000070000000000000000007000000000000006060606060111111111111111111111111011111111111111110010000000001111
1700000000000007000000700000000000000000000000060000000000000M0006111111111000000000000001010000000000001110010000000004411
17070000070000060000000000000070000000000000000000000O00000O00000011111111100T000000000000000000000000001110000000000030411
10000000000000000000000000000006000000000000000007000000O000070006111111111000000011111111111111111111111111111111111144411
170707070707070707070707070707070707070707070707070707070707777777111111111111111G11111111111111111111111111111111111111111
111111111111111111111111111111111111111111111111111111111111101111111111111111111011111111111111111111111111111111111111111
111111111111111111111111111111111111111111111111000000011111100000111111111111111000000000000000000051111111111111111111111
11111111111111111111111111111111111111111111111100000K011111111110111111111111111000000000000000000081111111111111111111111
111111111111111111111111111111111111111111111111000000011111100000111111111111111000000000000000000091111111111111111111111
1111111111111111111111111111111111111111111111110001111111111L1111111111111111111111111111111111111111111111111111111111111
111111111111111111111111111111111111111111111111000000000000001111111111111111111111111111111111111111111111111111111111111
111111111111111111111111111111111111111111111111111111111111111111111111111111111111111111111111111111111111111111111111111